111111111111111111111111111
10P000000100000000000100001
10000000010000000000010E001
100000000000000000000111111
100000000100000000000000001
100000000010000000000000001
1000000C0100000000000000001
1000000C0010000000000000001
10000000010000C000000000001
1000000C0010000000000C00001
1000000C0100000000000000001
100000000010000C00000000001
100000000100000000000000001
100000000010000000000C00001
111111111111111111111111111
