111111111111111111111111111
1CPCCCCCC1CCCCCCCCCCC1CCCC1
1CCCCCCCC1CCCCCCCCCCCCCECC1
1CCCCCCCCCCCCCCCCCCCC111111
1CCCCCCCC1CCCCCCCCCCCCCCCC1
1CCCCCCCCC1CCCCCCCCCCCCCCC1
1CCCCCCCC1CCCCCCCCCCCCCCCC1
1CCCCCCCCC1CCCCCCCCCCCCCCC1
1CCCCCCCC1CCCCCCCCCCCCCCCC1
1CCCCCCCCC1CCCCCCCCCCCCCCC1
1CCCCCCCC1CCCCCCCCCCCCCCCC1
1CCCCCCC1C1CCCCCCCCCCCCCCC1
1CCCCCCCC1CCCCCCCCCCCCCCCC1
1CCCCCCCCC1CCCCCCCCCCCCCCC1
111111111111111111111111111
