111111111111111111111111111
1CPCCCCCC1CCCCCCCCCCC1CCCC1
1CCCCCCCC0CC0CCCGCCCCCCECC1
111111111111111111111111111
