11111
1E001
10001
10PC1
11111
