1111111111111
10P0000100001
100000000E001
1000000111111
1000000000001
1000000000001
1000000000001
1000000C00001
1000000C00001
1000000C00001
1000000C00001
1111111111111
